WWWWWWWWWWWW
WDDDDDDDDDDW
WDDDDDDDDDDW
WDDDDDDDDDDW
WDDDDDDDDDDW
WDDDDDDDDDDW
WDDDDDDDDDDW
WDDDDDDDDDDW
WDDDDDDDDDDW
WDDDDDDDDDDW
WSDDDDDDDDDW
WWWWWWWWWWWW
